....###########..............................
..............#..............................
..............#..............................
..............#..............................
..............#..............................
..............#...........###############....
..............#...........#.............#....
..............#...........#.............#....
..............#...........#.............#....
..............#...........#.............#....
..............#...........#.............#....
..............#...........#.............#....
..............#...........#.............#....
..............#...........#.............#....
..............#...........#.............#....
..............#############.............####.
...........................................#.
...........................................#.
...........................................#.
...........................................#.
...........................................#.
........................................####.
.............................................
.............................................
.............................................
.............................................


